aboutVG - Aldeão 👱
aboutWW - Lobisomem 🐺
aboutDrunk Bebum 🍻
aboutSeer Vidente 👳
aboutCursed Infiel 😾
aboutHarlot Amante 💋
aboutBH Confidente 👁
aboutGunner Vigilante 🔫
aboutTraitor Traíra 🖕
aboutGA - Anjo da Guarda 👼
aboutDetective - Detetive 🕵
aboutAppS - Aprendiz de Vidente 🙇
aboutCult - Integrante da Seita 👤
aboutCH - Agente da Inquisição 💂
aboutWC - Criança Rebelde 👶
aboutFool - Trouxa 🃏
aboutMason - Maçom 👷
aboutDG - Doppelgänger 🎭
aboutCupid - Cupido 🏹
aboutHunter - Sentinela 🎯
aboutSK - Serial Killer 🔪
aboutTanner - Suicida 👺
aboutMayor - Xerife 🎖
aboutPrince - Realeza 👑
aboutSorcerer - Xamã 🔮
aboutClumsy - Sem-jeito 🤕
aboutBlacksmith - Alquimista ⚒
aboutAlphaWolf - Lobisomem Alfa ⚡️
aboutWolfCub - Filhote de Lobisomem 🐶
aboutSandman - Cantarolador 💤
aboutOracle - Oráculo 🌀
aboutWolfMan - O Homem-Lobo 👱🌚
aboutLycan - O Lycan 🐺🌝
aboutPacifist - Pacifista  ☮️
aboutWiseElder - Lobo Sensato 📚